8 8
2 4 18 6 18 2 25 -1
5 12 -1 2 12 1 24 5
5 7 26 4 15 17 21 -1
23 18 3 4 14 2 18 23
2 4 5 10 12 9 15 24
0 3 7 9 1 11 12 8
6 1 21 19 -1 0 8 5
8 9 13 16 21 13 -1 2
