8 8
0 1 2 3 4 5 1 0
1 2 3 4 5 3 2 1
-1 0 4 5 5 4 3 2
0 6 8 7 6 6 4 2
2 0 9 8 9 10 5 4
0 11 10 -1 10 11 3 8
13 12 3 4 8 12 13 7
14 8 12 2 2 5 14 15
